111111111111111
10C110000011C01
100C000P000C001
100000CEC000001
111X0101010X111
111111111111111